111111111111111112111
222345222222222222222
121212121212121212121
121216121212121212121
121212121212121212121
121212121212121212121
121222222212222212121
121211111212111612121
121222222212222212121
122211111112111222121
121222222022222212221
121211111211111212121
121222122212221212121
121212121212121212121
121212121212121212121
121212121212121212121
121212161212121212121
122212221222122222121
112111111111111112121
122222222222222222221
111111111111111112111