1111111111111111121
1623452222222222221
1212121212121212121
1212121212121212121
1212121212121212121
1212121212121212121
1212222222122222121
1212111112121116121
1212222222122222121
1222111111121112221
2212222220222222122
1212111112111112121
1212221222122212121
1212121212121212121
1212121212121212121
1212121212121212121
1212121612121212121
1222122212221222221
1111111111111111121