1111121
2222222
1212121
1212121
1212121
1202221
1111121